#domain
hospital
#levelname
ArmyAnts
#colors
blue: 0, A
red: 1, B
green : 2, C
#initial
++++++++++++
++++++++ +++
+++++    +++
+++++++0 +++
++++++++ +++
+    B 2C+ +
+ ++++++++A+
+          +
++++++++++ +
+1         +
++++++++++ +
++++++++++++
#goal
++++++++++++
++++++++C+++
+++++    +++
+++++++  +++
++++++++ +++
+        + +
+ ++++++++ +
+        B +
++++++++++ +
+          +
++++++++++A+
++++++++++++
#end
