#domain
hospital
#levelname
FGST
#colors
red: 0, A
green: 1, B
blue: 2, C
purple:3, D
#initial
+++++++++
+   +A+ +
+ + +C+ +
+ + + + +
+ + + + +
+ +0+1+ +
+ +   + +
+ +2+3+ +
+ + + + +
+ + + + +
+ +D+ + +
+ +B+   +
+++++++++
#goal
+++++++++
+  C+ +B+
+ + + + +
+ + + + +
+ + + + +
+ + + + +
+ +   + +
+ + + + +
+ + + + +
+ + + + +
+ + + + +
+A+ +D  +
+++++++++
#end