#domain
hospital
#levelname
GoAgentGo
#colors
cyan: 2, B, C
blue: 3, A, D
pink: 1, E
grey: 0, F
red: 4, G
#initial
+++++++++++++
+++++++ ADA +
+  2  + A A +
+B+ + + A3A +
+C+ + + A A +
+++++++++ +++
+++++++++ +++
+      1+4+ +
+ +++++++++E+
+           +
+FGGGGGGGGG +
+ +0        +
+++++++++++++
#goal
+++++++++++++
+++++++     +
+  2  +     +
+ + +B+     +
+ + +C+     +
+++++++++A+++
+++++++++D+++
+       + +E+
+ +++++++++ +
+           +
+           +
+F+         +
+++++++++++++
#end