#domain
hospital
#levelname
MAPF00
#colors
blue: 0, 1, A, A
#initial
++++++++++++++
+0   A+     1+
+     ++++++ +
+     +      +
+     +  +++ +
+     +    +A+
++++++++++++++
#goal
++++++++++++++
+0    +A     +
+     ++++++ +
+     +      +
+     +  +++ +
+A    +   1+ +
++++++++++++++
#end
