#domain
hospital
#levelname
CBSTest
#colors
blue: 0, A
red: 1, B
#initial
+++++++++++++++++++
+0                +
+              ++++
+                 +
+              ++A+
+1   B          + +
+++++++++++++++++++
#goal
+++++++++++++++++++
+                 +
+              ++++
+                 +
+              ++0+
+    1B         +A+
+++++++++++++++++++
#end
