#domain
hospital
#levelname
SAsoko3_08
#colors
blue: 0, A, B
#initial
++++++++++
+0A      +
+ A      +
+ A      +
+ A      +
+ B      +
+ A      +
+ B      +
+ A      +
++++++++++
#goal
++++++++++
+       A+
+       A+
+       B+
+       A+
+       A+
+       A+
+       A+
+       B+
++++++++++
#end
